*************************
*************************
*************************
##############***********
*************************
*************************
*************************
*************************
*************************
**********************###
*************************
*************************
*************************
*************************
*************************
*************************
**********###############
*************************
*************************
*************************
*************************
*************************
*************************
*************************
*************************
